#######
#o.#..#
#..B.P#
#oB.#.#
#.....#
#X.#..#
#######