  #####
###...###
#.o.B.o.#
#.#oBo#.#
#.B.#.B.#
###.P.###
  #####