  ####
 ##o.#
##..o##
#..X..#
#.B.B.#
###..P#
  #####